0,0,0,0,0,0,0,0,0,0,0,0,0,0,0,0,0,0,0,0,0,0,0,0,0,0,0,0,0,0,0,0,0,0,0,0,0,0,0,0,0,0,0,0,0,0,0,0,0,0
0,3,3,3,3,3,3,3,3,3,3,3,3,3,3,3,3,3,3,3,3,3,3,3,3,3,3,3,3,3,3,3,3,3,3,3,3,3,3,3,3,3,3,3,3,3,3,3,3,0
0,3,2,2,2,2,2,2,2,1,1,1,1,1,1,1,1,1,1,1,1,1,1,1,1,1,1,1,1,1,1,1,1,1,1,1,1,2,2,2,2,2,2,2,2,2,2,2,3,0
0,3,2,2,2,2,2,2,2,3,3,3,1,3,3,3,3,3,3,1,3,3,3,3,3,3,3,3,3,3,3,3,3,3,3,3,3,2,2,2,2,2,2,2,2,2,2,2,3,0
0,3,2,2,2,2,2,2,2,3,0,3,1,3,0,0,0,0,3,1,3,0,0,0,0,0,0,0,0,0,0,0,0,0,0,0,3,2,2,2,2,2,2,2,2,2,2,2,3,0
0,3,2,2,2,2,2,2,2,3,0,3,1,3,0,0,0,0,3,1,3,0,0,0,0,0,0,0,0,0,0,0,0,0,0,0,3,2,2,2,2,2,2,2,2,2,2,2,3,0
0,3,2,2,2,2,2,2,2,3,0,3,1,3,3,3,3,3,3,1,3,0,0,0,0,0,0,0,0,0,0,0,0,0,0,0,3,3,3,3,3,3,3,3,2,2,2,2,3,0
0,3,2,2,2,2,2,2,2,3,0,3,1,2,2,2,1,1,1,1,3,0,0,3,3,3,3,3,3,3,3,3,3,3,3,3,3,3,3,0,0,0,0,3,3,1,3,3,3,0
0,3,1,3,3,3,3,3,3,3,0,3,3,2,2,2,3,3,3,1,3,0,0,3,1,1,1,1,1,1,1,1,1,2,2,2,2,2,3,3,3,3,0,0,3,1,3,0,0,0
0,3,1,3,0,0,0,0,0,0,0,0,3,2,2,2,3,0,3,1,3,0,0,3,1,3,3,3,3,3,3,3,3,2,2,2,2,1,1,1,1,3,0,0,3,1,3,0,0,0
0,3,1,3,0,0,0,0,0,0,0,0,3,2,2,2,3,0,3,1,3,0,0,3,1,3,0,0,0,0,0,0,3,2,2,2,2,3,3,3,1,3,0,0,3,1,3,0,0,0
0,3,1,3,0,0,0,0,0,0,0,0,3,3,1,3,3,0,3,1,3,0,0,3,1,3,0,0,0,0,0,0,3,2,2,2,2,3,0,3,1,3,0,0,3,1,3,0,0,0
0,3,1,3,0,0,0,0,0,0,0,0,0,3,1,3,0,0,3,1,3,0,0,3,3,3,0,0,0,0,0,0,3,2,2,2,2,3,0,3,1,3,0,0,3,1,3,0,0,0
0,3,1,3,0,0,0,0,0,0,0,0,0,3,1,3,0,0,3,1,3,0,0,0,0,0,0,0,0,3,3,3,3,1,3,3,3,3,0,3,1,3,0,0,3,1,3,0,0,0
0,3,1,3,0,0,0,0,0,0,0,0,0,3,1,3,0,0,3,1,3,0,0,0,0,0,0,0,0,3,1,1,1,1,3,0,0,0,0,3,1,3,0,0,3,1,3,0,0,0
0,3,1,3,0,0,0,0,0,0,0,0,0,3,1,3,0,0,3,1,3,0,0,0,0,0,0,0,0,3,1,3,3,1,3,0,0,0,0,3,1,3,0,0,3,1,3,0,0,0
0,3,1,3,0,0,0,0,0,0,0,0,0,3,1,3,0,0,3,1,3,0,0,0,0,0,0,0,0,3,1,3,3,1,3,0,0,0,0,3,1,3,0,0,3,1,3,0,0,0
0,3,1,3,0,0,0,0,0,3,3,3,3,3,1,3,0,0,3,3,3,3,3,3,3,3,0,0,0,3,1,3,3,1,3,0,0,0,0,3,1,3,0,0,3,1,3,0,0,0
0,3,1,3,0,0,0,0,0,3,1,1,1,1,1,3,0,0,0,3,2,2,2,2,2,3,0,0,0,3,1,3,3,1,3,0,0,0,0,3,1,3,0,0,3,1,3,0,0,0
0,3,1,3,0,0,0,0,1,3,1,3,3,3,1,3,0,0,0,3,2,2,5,2,2,3,0,0,0,3,1,3,3,1,3,0,0,0,3,3,1,3,0,0,3,1,3,0,0,0
0,3,1,3,0,0,0,0,1,3,1,3,3,3,1,3,0,0,0,3,2,2,2,2,2,3,0,0,0,3,1,3,3,1,3,3,3,3,3,1,1,3,0,0,3,1,3,0,0,0
0,3,3,3,0,0,1,3,3,3,2,2,3,3,1,3,0,0,0,3,3,2,2,2,2,3,0,0,0,3,1,3,3,1,1,1,1,1,1,1,3,3,0,0,3,1,3,3,0,0
0,0,0,0,0,0,1,3,2,2,2,2,3,3,1,3,0,0,0,0,3,2,2,2,2,3,0,0,0,3,1,3,3,3,3,3,3,3,3,3,3,0,0,0,3,2,2,3,0,0
0,0,0,0,0,3,3,3,2,2,2,2,3,3,1,3,0,0,0,0,3,3,3,3,1,3,0,0,0,3,1,3,3,0,0,0,0,0,0,0,3,3,3,3,3,2,2,3,3,0
0,0,0,0,0,3,2,2,2,2,2,2,3,3,1,3,0,0,0,0,0,0,0,3,1,3,0,0,0,3,1,3,3,3,3,3,3,3,3,3,3,2,2,2,2,2,2,2,3,0
0,0,0,3,3,3,2,2,2,4,2,2,3,3,1,3,3,3,3,3,3,3,3,3,1,3,0,0,0,3,1,1,1,1,1,1,1,1,1,1,1,2,2,2,2,2,2,2,3,0
0,0,0,3,2,2,2,2,2,2,2,2,3,3,1,1,1,1,1,1,1,1,3,3,1,3,3,3,3,3,3,3,3,3,1,3,3,3,3,3,3,2,2,2,2,2,2,2,3,0
0,0,0,3,2,2,2,2,2,2,2,2,3,3,3,3,3,3,3,3,3,1,1,1,1,1,1,1,1,1,1,1,1,1,1,3,0,0,0,0,3,2,2,2,2,2,2,2,3,0
0,0,0,3,3,3,3,3,3,3,3,3,3,0,0,0,0,0,0,0,3,3,3,3,3,3,3,3,3,3,3,3,3,3,3,3,0,0,0,0,3,3,3,3,3,3,3,3,3,0
0,0,0,0,0,0,0,0,0,0,0,0,0,0,0,0,0,0,0,0,0,0,0,0,0,0,0,0,0,0,0,0,0,0,0,0,0,0,0,0,0,0,0,0,0,0,0,0,0,0
